DDBooster	KEYWORD1
LED_RGB	KEYWORD1
LED_RGBW	KEYWORD1
ORDER_RGB	KEYWORD1
ORDER_GRB	KEYWORD1
configurePins	KEYWORD2
init	KEYWORD2
reset	KEYWORD2
setRGB	KEYWORD2
setRGBW	KEYWORD2
setHSV	KEYWORD2
setLED	KEYWORD2
clearLED	KEYWORD2
setAll	KEYWORD2
clearAll	KEYWORD2
setRange	KEYWORD2
setRainbow	KEYWORD2
setGradient	KEYWORD2
shiftUp	KEYWORD2
shiftDown	KEYWORD2
copyLED	KEYWORD2
repeat	KEYWORD2
show	KEYWORD2